*********
*P0000*0*
*0*****0*
*0*0*000*
*0*0*0*0*
*000*0*0*
*0***0*0*
*00000*0F
*********
